##################################################
#           $          #            #            #
# #################### ############ # ############
#                                          #    ##
############## #################### ###### #     #
#                      @ #                    ####
#######           #      #            ############
#######################       ######             #
#                                                #
##################################################